6 12
|----------|
|F...|...-.|
|..-.....w.|
|....|..@..|
|F......-..|
|----------|
